############
#%:::::::::#
#::::::::::#
#%%%%:::::%#
############