##########    ##########
#::::::::#    #::::::::#
#:::::::://////::::::::#
#::::::::#    #::::::::#
#::::::::#    #::::::::#
##########    ##########