##############################################################
#::::::::::::::::::::::::::::::::::::::::::::::::::::::::::::#
#::::::::::::::::::::::::::::::::::::::::::::::::::::::::::::#
#::::::::::::::::::::::::::::::::::::::::::::::::::::::::::::#
#::::::::::::::::::::::::::::::::::::::::::::::::::::::::::::#
#::::::::::::::::::::::::::::::::::::::::::::::::::::::::::::#
#::::::::::#########################################:::::::::#
#::::::::::#                                       #:::::::::#
#::::::::::#                                       #:::::::::#
#::::::::::#                                       #:::::::::#
#::::::::::#                                       #:::::::::#
#::::::::::#                                       #:::::::::#
#::::::::::#                                       #:::::::::#
#::::::::::#                                       #:::::::::#
#::::::::::#                                       #:::::::::#
#::::::::::#                                       #:::::::::#
#::::::::::#                                       #:::::::::#
#::::::::::#                                       #:::::::::#
#::::::::::#########################################:::::::::#
#::::::::::::::::::::::::::::::::::::::::::::::::::::::::::::#
#::::::::::::::::::::::::::::::::::::::::::::::::::::::::::::#
#::::::::::::::::::::::::::::::::::::::::::::::::::::::::::::#
#::::::::::::::::::::::::::::::::::::::::::::::::::::::::::::#
#::::::::::::::::::::::::::::::::::::::::::::::::::::::::::::#
##############################################################